################
#X#   L@       #
# #            #
# #          # #
# #          # #
# #          # #
# #          # #
# #          # #
# #          # #
# #          # #
# #          # #
# #          # #
# #d        d# #
# ############ #
#              #
################
